#############################################
#                   0                       #
#    ##   ######      ###   # ###           #
#         #        #       #      ########  #
#   #######        #       #      #         #
#         #   #################   #   #     #
#       ###       #               #####     #
#        #################################  #
#                                           #
#   ######################################  #
#                   @                       #
#  #####          #####   ############      #
#         #####                #            #
##    #             #          #  ##### ##  #
#     #      ## ########       #         #  #
# #########     #   #     ############## #  #
#                                           #
#############################################